    ██████████    
  ██          ██  
██              ██
██              ██
██              ██
██              ██
██              ██
  ██          ██  
    ██████████    